,Month,total_cus,new_cus,exis_cus,new_exis_ratio
0,1,741,417,324,1.29
1,2,758,380,378,1.01
2,3,974,452,522,0.87
3,4,856,300,556,0.54
4,5,1056,284,772,0.37
5,6,991,242,749,0.32
6,7,949,188,761,0.25
7,8,935,169,766,0.22
8,9,1266,299,967,0.31
9,10,1364,358,1006,0.36
10,11,1664,323,1341,0.24
11,12,1265,41,1224,0.03
